border_size=1
usage=map

Urb         , Urb         , Urb         , Urb         , Urb         , Urb         , Urb         , Urb         , Urb         , Urb         , Urb         , Xol         , Xol         , Xos         , Xos         , Xos         , Xos         , Xos         , Ql          , Xos         , Xos         , Xos         , Ql          , Xos         , Xos         , Xos         , Xos         , Xos         , Xol         , Xol         , Urb         , Urb         , Urb         , Urb         , Urb         , Urb         , Urb         , Urb         , Urb         , Urb         , Urb         
Urb         , Urb         , Urb         , Urb         , Urb         , Urb         , Urb         , Urb         , Urb         , Urb         , Urb         , Urb         , Urb         , Xol         , Xol         , Xos         , Ql          , Ql          , Ql          , Ql          , Ql          , Ql          , Ql          , Ql          , Ql          , Xos         , Xol         , Xol         , Urb         , Urb         , Urb         , Urb         , Urb         , Urb         , Urb         , Urb         , Urb         , Urb         , Urb         , Urb         , Urb         
Urb         , Urb         , Urb         , Urb         , Urb         , Urb         , Urb         , Urb         , Urb         , Urb         , Urb         , Urb         , Urb         , Urb         , Ql          , Ql          , Ql          , Ql          , Urb         , Ql          , Ql          , Ql          , Urb         , Ql          , Ql          , Ql          , Ql          , Urb         , Urb         , Urb         , Urb         , Urb         , Urb         , Urb         , Urb         , Urb         , Urb         , Urb         , Urb         , Urb         , Urb         
Urb         , Urb         , Urb         , Urb         , Urb         , Urb         , Urb         , Urb         , Urb         , Urb         , Urb         , Urb         , Ql          , Ql^Bsb\     , Ql^Bsb\     , Ql          , Urb         , Urb         , Xos         , Urb         , Urb         , Urb         , Xos         , Urb         , Urb         , Ql          , Ql^Bsb/     , Ql^Bsb/     , Ql          , Urb         , Urb         , Urb         , Urb         , Urb         , Urb         , Urb         , Urb         , Urb         , Urb         , Urb         , Urb         
Xos         , Urb         , Urb         , Urb         , Urb         , Urb         , Urb         , Urb         , Urb         , Urb         , Ql^Bsb\     , Ql          , Ql          , Ql          , Urb         , Urb         , Xos         , Xos         , Ur          , Xos         , Xos         , Xos         , Ur          , Xos         , Xos         , Urb         , Urb         , Ql          , Ql          , Ql          , Ql^Bsb/     , Urb         , Urb         , Urb         , Urb         , Urb         , Urb         , Urb         , Urb         , Urb         , Xol         
Xos         , Xol         , Xol         , Urb         , Urb         , Urb         , Urb         , Urb         , Ql          , Ql          , Ql          , Ql^Bsb\     , Urb         , Urb         , Xos         , Xos         , Xos         , Xos         , Ur          , Ur          , Ur          , Ur          , Ur          , Xos         , Xos         , Xos         , Xos         , Urb         , Urb         , Ql^Bsb/     , Ql          , Ql          , Ql          , Urb         , Urb         , Urb         , Urb         , Urb         , Xol         , Xol         , Xos         
Xos         , Xol         , Xol         , Xol         , Xos         , Urb         , Ql          , Ql^Bsb\     , Ql^Bsb\     , Ql          , Urb         , Urb         , Xos         , Xos         , Xos         , 8 Xos       , Xos         , Xos         , Xos         , Ur          , Xos         , Ur          , Xos         , Xos         , Xos         , Xos         , Xos         , Xos         , Xos         , Urb         , Urb         , Ql          , Ql^Bsb/     , Ql^Bsb/     , Ql          , Urb         , Xol         , Xol         , Xos         , Xos         , Xos         
Xos         , Xos         , Xos         , Xos         , Ql          , Ql          , Ql          , Ql          , Urb         , Urb         , Xos         , Xos         , Xos         , Xos         , Xos         , Xos         , Ww          , Hh          , Mm          , Xos         , Rp          , Xos         , Gg          , Hh          , Gg          , Xos         , Xos         , Xos         , Xos         , Xos         , Xos         , Urb         , Urb         , Ql          , Ql          , Ql          , Ql          , Xos         , Xos         , Xos         , Xos         
Xos         , Xos         , Xol         , Xol         , Ql          , Ql          , Urb         , Urb         , Xos         , Xos         , Xos         , Xos         , Xos         , Xos         , Ww          , Hh          , Ch          , Hh          , Rp          , Rp          , Gg          , Hh          , Mm          , Ch          , Hh          , Gg          , Ww          , Xos         , Xos         , Xos         , Xos         , Xos         , Xos         , Urb         , Urb         , Ql          , Ql          , Xos         , Xos         , Xos         , Xos         
Xos         , Xol         , Xos         , Xos         , Ql          , Ql          , Urb         , Xos         , Ur          , Xos         , Xos         , Xos         , Aa          , Aa^Fpa      , Ww          , Gg          , Mm          , Gg          , Rp          , Ww          , Hh          , Ww          , Ww          , Gg          , Hh          , Ww          , Uh          , Uu          , Uu          , Xos         , Xos         , Xos         , Ur          , Xos         , Urb         , Ql          , Ql          , Xos         , Xos         , Xos         , Xos         
Xos         , Xos         , Ql          , Ql          , Ql          , Ql          , Urb         , Xos         , Ur          , Ur          , Xos         , Aa          , Coa         , Aa          , Ms          , Ww          , Gg          , Mm          , Gg          , Rp          , Rp          , Gg          , Hh          , Ww          , Ww          , Ww          , Uu          , Cud         , Uh          , Uu          , Xos         , Ur          , Ur          , Xos         , Urb         , Ql          , Ql          , Ql          , Ql          , Xos         , Xos         
Xos         , Xos         , Ql          , Ql          , Urb         , Urb         , Xos         , Xos         , Ur          , Ur          , Xos         , Aa^Fpa      , Aa^Fpa      , Aa          , Ai          , Ai          , Ww          , Hh          , Ww          , Hh          , Rp          , Hh          , Mm          , Gg          , Ww          , Uh          , Uh          , Uu          , Urb         , Uu          , Xos         , Ur          , Ur          , Xos         , Xos         , Urb         , Urb         , Ql          , Ql          , Xos         , Xos         
Xos         , Xos         , Ql          , Ql          , Urb         , Xos         , Ur          , Ur          , Ur          , Xos         , Rrc         , Aa          , Ai          , Ai          , Aa          , Aa          , Ha          , Ww          , Hh          , Hh          , Rp          , Gg          , Hh          , Gg          , Ww          , Uu^Uf       , Uu          , Urb         , Uh          , Urb         , Urb         , Xos         , Ur          , Ur          , Ur          , Xos         , Urb         , Ql          , Ql          , Xos         , Xos         
Xos         , Xos         , Ql          , Ql          , Urb         , Xos         , Xos         , Ur          , Xos         , Xos         , Rrc         , Aa          , Aa^Fpa      , Aa          , Aa          , Ha^Fda      , Aa          , Ww          , Gg          , Gg          , Rp          , Hh          , Ww          , Ww          , Uu^Uf       , Ww          , Uh          , Urb         , Ww          , Uh          , Uu          , Xos         , Xos         , Ur          , Xos         , Xos         , Urb         , Ql          , Ql          , Xos         , Xos         
Xos         , Xos         , Ql          , Ql          , Urb         , Xos         , Xos         , Xos         , Aa          , Aa^Fpa      , Rrc         , Aa          , Rrc         , Rrc         , Rrc         , Aa          , Ha          , Ai          , Ww          , Mm          , Rp          , Gg          , Ww          , Uu          , Uu          , Uh          , Urb         , Urb         , Uh          , Uu          , Uu^Uf       , Uu^Uf       , Uu          , Xos         , Xos         , Xos         , Urb         , Ql          , Ql          , Xos         , Xos         
Xos         , Xos         , Ql          , Ql          , Urb         , Xos         , Xos         , Xos         , Aa          , Aa^Fpa      , Aa          , Rrc         , Aa          , Aa          , Aa^Fpa      , Rrc         , Rrc         , Aa          , Aa^Fpa      , Ww          , Ww^Bw|      , Hh          , Ww          , Uh          , Urb         , Urb         , Uu^Uf       , Ww          , Uu          , Ww          , Uu          , Cud         , Uu          , Xos         , Xos         , Xos         , Urb         , Ql          , Ql          , Xos         , Xos         
Xos         , Xos         , Ql          , Ql          , Urb         , Xos         , Xos         , Xos         , Aa          , Coa         , Ai          , Ms          , Ha          , Ai          , Aa          , Aa          , Ha          , Rrc         , Ww^Bw\      , Ww          , 2 Wwt^Bw|   , Ww          , Ww^Bw/r     , Urb         , Uu          , Uu^Uf       , Uu          , Uh          , Uu          , Ww          , Uh          , Uu          , Uu^Uf       , Xos         , Xos         , Xos         , Urb         , Ql          , Ql          , Xos         , Xos         
Xos         , Xos         , Ql          , Ql          , Urb         , Xos         , Xos         , Xos         , Ww          , Aa          , Ww          , Aa          , Ww          , Ai          , Ww          , Aa          , Ww          , Ww          , Ww          , 7 Wwt^Bw\   , Wwt^Bw|     , 3 Wwt^Bw/   , Ww          , Uu^Uf       , Ww          , Ww          , Ww          , Uu          , Ww          , Ww          , Ww          , Ww          , Ww          , Xos         , Xos         , Xos         , Urb         , Ql          , Ql          , Xos         , Xos         
Xos         , Xos         , Ql          , Ql          , Urb         , Xos         , Xos         , Xos         , Ss          , Ai          , Ss          , Ww          , Ss          , Ss          , Ss          , Ww          , Ss          , Ss          , Ww^Bw/r     , 6 Wwt^Bw/   , 5 Wwt^Bw|   , 4 Wwt^Bw\   , Ww^Bw\      , Ww          , Hd          , Dd          , Dd^Do       , Ww          , Dd          , Hd          , Dd          , Dd          , Dd^Do       , Xos         , Xos         , Xos         , Urb         , Ql          , Ql          , Xos         , Xos         
Xos         , Xos         , Ql          , Ql          , Urb         , Xos         , Xos         , Xos         , Ss          , Ww          , Ss^Bw/      , Ww          , Ss          , Ww          , Ww          , Ss          , Ww^Bw/      , Rr          , Ww          , Ww          , Ww^Bw|      , Ww          , Hd          , Rd          , Rd          , Dd          , Dd          , Ww          , Dd          , Hd          , Dd          , Cdr         , Dd          , Xos         , Xos         , Xos         , Urb         , Ql          , Ql          , Xos         , Xos         
Xos         , Xos         , Ql          , Ql          , Urb         , Xos         , Xos         , Xos         , Ss          , Chs         , Ww          , Ww^Bw\      , Ss^Bw\      , Ss          , Rp          , Ss^Bw/      , Ss          , Ww          , Ww          , Gg^Fet      , Rb          , Ww          , Ww          , Dd          , Dd          , Rd          , Rd          , Dd^Dc       , Rd          , Rd          , Rd          , Dd^Dc       , Hd          , Xos         , Xos         , Xos         , Urb         , Ql          , Ql          , Xos         , Xos         
Xos         , Xos         , Ql          , Ql          , Urb         , Xos         , Xos         , Xos         , Xos         , Ss          , Ss          , Ss          , Ww          , Rp          , Ss          , Ww          , Ss          , Ss          , Ww          , Gll         , Rb          , Gll^Fp      , Gll         , Ww          , Dd          , Hd          , Dd          , Rd          , Dd          , Dd          , Rd          , Hd          , Xos         , Xos         , Xos         , Xos         , Urb         , Ql          , Ql          , Xos         , Xos         
Xos         , Xos         , Ql          , Ql          , Urb         , Xos         , Ur          , Ur          , Ur          , Xos         , Rp          , Ww          , Ss          , Ss^Bw|      , Ss          , Ww          , Ww          , Ww          , Gll         , Hh^Fp       , Rb          , Ww          , Gll^Fp      , Ww          , Dd^Do       , Dd          , Hd          , Hd          , Dd^Dc       , Hd          , Rd          , Xos         , Ur          , Ur          , Ur          , Xos         , Urb         , Ql          , Ql          , Xos         , Xos         
Xos         , Xos         , Ql          , Ql          , Urb         , Xos         , Xos         , Ur          , Ur          , Xos         , Xos         , Ss^Bw\      , Rp          , Rp          , Ww          , Ss          , Ww          , Gg^Fet      , Gll^Fp      , Gll         , Rb          , Gll^Fp      , Ww          , Ww          , Ww          , Dd          , Ww          , Ww          , Dd          , Dd          , Xos         , Xos         , Ur          , Ur          , Xos         , Xos         , Urb         , Ql          , Ql          , Xos         , Xos         
Xos         , Xos         , Ql          , Ql          , Ql          , Urb         , Urb         , Xos         , Ur          , Ur          , Xos         , Ss          , Ww          , Ss          , Ss          , Ss          , Ww          , Gll^Fp      , Gll^Fp      , Hh^Fp       , Rb          , Gg^Fet      , Gll^Fp      , Gll^Fp      , Gll^Fp      , Ww          , Hd          , Dd          , Cdr         , Hd          , Xos         , Ur          , Ur          , Xos         , Urb         , Urb         , Ql          , Ql          , Ql          , Xos         , Xos         
Xos         , Xos         , Xos         , Ql          , Ql          , Ql          , Urb         , Xos         , Ur          , Ur          , Xos         , Ss          , Ss          , Chs         , Ss          , Ww          , Gll^Fp      , Ww          , Ww          , Gll^Fp      , Gll         , Rb          , Rb          , Hh^Fp       , Ww          , Ww          , Ww          , Dd^Dc       , Hd          , Dd          , Xos         , Ur          , Ur          , Xos         , Urb         , Ql          , Ql          , Ql          , Xos         , Xos         , Xos         
Xos         , Xos         , Xos         , Xos         , Ql          , Ql          , Urb         , Xos         , Xos         , Xos         , Xos         , Xos         , Xos         , Ss          , Ww          , Ww          , Gll^Fp      , Gll^Fp      , Gll^Fp      , Gll         , Hh^Fp       , Gll         , Rb          , Gll         , Ce          , Gg^Fet      , Ww          , Hd          , Xos         , Xos         , Xos         , Xos         , Xos         , Xos         , Urb         , Ql          , Ql          , Xos         , Xos         , Xos         , Xos         
Xos         , Xos         , Xos         , Xos         , Ql          , Ql          , Ql          , Urb         , Urb         , Xos         , Xol         , Xos         , Xos         , Xos         , Xos         , Gg^Fet      , Ww          , Ce          , Gll         , Gll         , Rb          , Rb          , Gg^Fet      , Gll^Fp      , Gll^Fp      , Gll         , Xos         , Xos         , Xos         , Xos         , Xos         , Xos         , Urb         , Urb         , Ql          , Ql          , Ql          , Xos         , Xos         , Xos         , Xos         
Xos         , Xos         , Xos         , Xos         , Xol         , Ql          , Ql          , Ql          , Ql^Bsb/     , Urb         , Urb         , Xos         , Xos         , Xos         , Xos         , Xos         , Xos         , Gll         , Xos         , Xos         , Xos         , Xos         , Xos         , Gll^Fp      , Xos         , Xos         , Xos         , Xos         , Xos         , Xos         , Urb         , Urb         , Ql^Bsb\     , Ql          , Ql          , Ql          , Xol         , Xos         , Xos         , Xos         , Xos         
Xos         , Xos         , Xol         , Xol         , Urb         , Urb         , Urb         , Ql^Bsb/     , Ql          , Ql          , Ql          , Urb         , Urb         , Xos         , Xos         , Xos         , Xos         , Xos         , Ur          , Ur          , Ur          , Ur          , Ur          , Xos         , Xos         , Xos         , Xos         , Xos         , Urb         , Urb         , Ql          , Ql          , Ql          , Ql^Bsb\     , Urb         , Urb         , Urb         , Xol         , Xol         , Xos         , Xos         
Xol         , Xol         , Urb         , Urb         , Urb         , Urb         , Urb         , Urb         , Urb         , Ql          , Ql^Bsb/     , Ql^Bsb/     , Ql          , Urb         , Urb         , Xos         , Xos         , Xos         , Ur          , Ur          , Xos         , Ur          , Ur          , Xos         , Xos         , Xos         , Urb         , Urb         , Ql          , Ql^Bsb\     , Ql^Bsb\     , Ql          , Urb         , Urb         , Urb         , Urb         , Urb         , Urb         , Urb         , Xol         , Xol         
Urb         , Urb         , Urb         , Urb         , Urb         , Urb         , Urb         , Urb         , Urb         , Urb         , Urb         , Ql          , Ql          , Ql          , Ql^Bsb/     , Urb         , Urb         , Xos         , Xos         , Xos         , Urb         , Xos         , Xos         , Xos         , Urb         , Urb         , Ql^Bsb\     , Ql          , Ql          , Ql          , Urb         , Urb         , Urb         , Urb         , Urb         , Urb         , Urb         , Urb         , Urb         , Urb         , Urb         
Urb         , Urb         , Urb         , Urb         , Urb         , Urb         , Urb         , Urb         , Urb         , Urb         , Urb         , Urb         , Urb         , Ql^Bsb/     , Ql          , Ql          , Ql          , Urb         , Urb         , Urb         , Ql          , Urb         , Urb         , Urb         , Ql          , Ql          , Ql          , Ql^Bsb\     , Urb         , Urb         , Urb         , Urb         , Urb         , Urb         , Urb         , Urb         , Urb         , Urb         , Urb         , Urb         , Urb         
Urb         , Urb         , Urb         , Urb         , Urb         , Urb         , Urb         , Urb         , Urb         , Urb         , Urb         , Urb         , Urb         , Urb         , Xos         , Ql          , Ql          , Ql          , Ql          , Ql          , Ql          , Ql          , Ql          , Ql          , Ql          , Ql          , Xos         , Urb         , Urb         , Urb         , Urb         , Urb         , Urb         , Urb         , Urb         , Urb         , Urb         , Urb         , Urb         , Urb         , Urb         
Urb         , Urb         , Urb         , Urb         , Urb         , Urb         , Urb         , Urb         , Urb         , Urb         , Urb         , Urb         , Xos         , Xos         , Xos         , Xos         , Xos         , Ql          , Ql          , Ql          , Ql          , Ql          , Ql          , Ql          , Xos         , Xos         , Xos         , Xos         , Xos         , Urb         , Urb         , Urb         , Urb         , Urb         , Urb         , Urb         , Urb         , Urb         , Urb         , Urb         , Urb         
