border_size=1
usage=map

Rrc         , Rrc         , Rrc         , Rrc         , Rrc         , Rrc         , Rrc         , Rrc         , Rrc         , Rrc         , Rrc         , Rrc         , Rrc         , Rrc         , Rrc         , Rrc         , Rrc         , Rrc         , Wog         , Rrc         , Rrc         , Rrc         , Wog         , Rrc         , Rrc         , Rrc         , Rrc         , Rrc         , Rrc         , Rrc         , Rrc         , Rrc         , Rrc         , Rrc         , Rrc         , Rrc         , Rrc         , Rrc         , Rrc         , Rrc         , Rrc         
Rrc         , Rrc         , Rrc         , Rrc         , Rrc         , Rrc         , Rrc         , Rrc         , Rrc         , Rrc         , Rrc         , Rrc         , Rrc         , Rrc         , Rrc         , Rrc         , Wog         , Wog         , Wog         , Wog         , Wog         , Wog         , Wog         , Wog         , Wog         , Rrc         , Rrc         , Rrc         , Rrc         , Rrc         , Rrc         , Rrc         , Rrc         , Rrc         , Rrc         , Rrc         , Rrc         , Rrc         , Rrc         , Rrc         , Rrc         
Rrc         , Rrc         , Rrc         , Rrc         , Rrc         , Rrc         , Rrc         , Rrc         , Rrc         , Rrc         , Rrc         , Rrc         , Rrc         , Rrc         , Wog         , Wog         , Wog         , Wog         , Rrc         , Wog         , Wog         , Wog         , Rrc         , Wog         , Wog         , Wog         , Wog         , Rrc         , Rrc         , Rrc         , Rrc         , Rrc         , Rrc         , Rrc         , Rrc         , Rrc         , Rrc         , Rrc         , Rrc         , Rrc         , Rrc         
Rrc         , Rrc         , Rrc         , Rrc         , Rrc         , Rrc         , Rrc         , Rrc         , Rrc         , Rrc         , Rrc         , Rrc         , Wog         , Wog^Bsb\    , Wog^Bsb\    , Wog         , Rrc         , Rrc         , Xos         , Rrc         , Rrc         , Rrc         , Xos         , Rrc         , Rrc         , Wog         , Wog^Bsb/    , Wog^Bsb/    , Wog         , Rrc         , Rrc         , Rrc         , Rrc         , Rrc         , Rrc         , Rrc         , Rrc         , Rrc         , Rrc         , Rrc         , Rrc         
Rrc         , Rrc         , Rrc         , Rrc         , Rrc         , Rrc         , Rrc         , Rrc         , Rrc         , Rrc         , Wog         , Wog         , Wog         , Wog         , Rrc         , Rrc         , Xos         , Xos         , Rb          , Xos         , Xos         , Xos         , Rb          , Xos         , Xos         , Rrc         , Rrc         , Wog         , Wog         , Wog         , Wog         , Rrc         , Rrc         , Rrc         , Rrc         , Rrc         , Rrc         , Rrc         , Rrc         , Rrc         , Rrc         
Rrc         , Rrc         , Rrc         , Rrc         , Rrc         , Rrc         , Rrc         , Rrc         , Wog         , Wog^Bsb\    , Wog^Bsb\    , Wog         , Rrc         , Rrc         , Xos         , Xos         , Xos         , Xos         , Rb          , Rb          , Rb          , Rb          , Rb          , Xos         , Xos         , Xos         , Xos         , Rrc         , Rrc         , Wog         , Wog^Bsb/    , Wog^Bsb/    , Wog         , Rrc         , Rrc         , Rrc         , Rrc         , Rrc         , Rrc         , Rrc         , Rrc         
Rrc         , Rrc         , Rrc         , Rrc         , Rrc         , Rrc         , Wog         , Wog         , Wog         , Wog         , Rrc         , Rrc         , Xos         , Xos         , 5 Xos       , Xos         , Xos         , Xos         , Xos         , Rb          , Xos         , Rb          , Xos         , Xos         , Xos         , Xos         , Xos         , Xos         , Xos         , Rrc         , Rrc         , Wog         , Wog         , Wog         , Wog         , Rrc         , Rrc         , Rrc         , Rrc         , Rrc         , Rrc         
Rrc         , Rrc         , Rrc         , Rrc         , Wog         , Wog^Bsb\    , Wog^Bsb\    , Wog         , Rrc         , Rrc         , Xos         , Xos         , Xos         , Xos         , Xos         , Xos         , Gs          , Gg          , Gs          , Xos         , Wwf         , Xos         , Ss          , Ss          , Ss          , Xos         , Xos         , Xos         , Xos         , Xos         , Xos         , Rrc         , Rrc         , Wog         , Wog^Bsb/    , Wog^Bsb/    , Wog         , Rrc         , Rrc         , Rrc         , Rrc         
Rrc         , Rrc         , Wog         , Wog         , Wog         , Wog         , Rrc         , Rrc         , Xos         , Xos         , Xos         , Xos         , Xos         , Xos         , Mm          , Mm          , Gs^Efm      , Hh          , Mm          , Wwf         , Wwf         , Ss          , Ss          , Ss^Bw|      , Ss^Bw\      , Ss          , Ss          , Xos         , Xos         , Xos         , Xos         , Xos         , Xos         , Rrc         , Rrc         , Wog         , Wog         , Wog         , Wog         , Rrc         , Rrc         
Rrc         , Rrc         , Wog         , Wog         , Rrc         , Rrc         , Xos         , Xos         , Xos         , Xos         , Xos         , Xos         , Mm          , Hh          , Gg          , Mm          , Gs          , Mm          , Hh          , Wwf         , Wwf         , Wwg         , Wwg         , Wwg^Bw|r    , Wwf         , Ss          , Chs         , Ss          , Ss          , Xos         , Xos         , Xos         , Xos         , Xos         , Xos         , Rrc         , Rrc         , Wog         , Wog         , Rrc         , Rrc         
Rrc         , Rrc         , Wog         , Wog         , Rrc         , Xos         , Xos         , Xos         , Xos         , Xos         , Hh          , Mm          , Hh          , Hh          , Gg^Efm      , Gs^Es       , Wwf         , Gs^Efm      , Wwrg        , Hh          , Wwf         , Wwg         , Ss          , Wwf^Bw|r    , Wwrg        , Wwf         , Ss          , Ss^Bw\      , Ss^Bw\      , Ss          , Ss          , Xos         , Xos         , Xos         , Xos         , Xos         , Rrc         , Wog         , Wog         , Rrc         , Rrc         
Rrc         , Rrc         , Wog         , Wog         , Rrc         , Xos         , Xos         , Xos         , Wog         , Wog         , Hh          , Mm          , Mm          , Gs          , Hh          , Wwf         , Gs          , Wwf         , Wwg         , Wwf         , Wwrg        , Wwf         , Ss          , Wwg^Bw|     , Wwf^Bw\     , Ss          , Ss^Bw|r     , Gs^Ft       , Wwg         , Ss          , Ss          , Ss          , Ss          , Xos         , Xos         , Xos         , Rrc         , Wog         , Wog         , Rrc         , Rrc         
Rrc         , Rrc         , Wog         , Wog         , Rrc         , Xos         , Xos         , Xos         , Wog         , Wog         , Wog         , Mm          , Gg^Efm      , Gs^Efm      , Gs^Efm      , Gg          , Mm          , Hh          , Hh          , Hh          , Gs          , Wwf         , Wwf         , Ss          , Ss^Bw/      , Ss^Bw/r     , Ss          , Wwf         , Ss          , Wwg         , Wog         , Wog         , Wog         , Xos         , Xos         , Xos         , Rrc         , Wog         , Wog         , Rrc         , Rrc         
Rrc         , Rrc         , Wog         , Wog         , Rrc         , Xos         , Xos         , Xos         , Dd          , Wog         , Dd          , Wwrg        , Wog         , Mm          , Gs          , Hh          , Mm          , Hh^Fms      , Gg^Es       , Gg^Efm      , Gg^Efm      , Wwg         , Ss          , Ss^Bw/      , Wwf         , Wwf         , Wwg         , Chw         , Wwf         , Wwrg        , Wog         , Wog         , Wog         , Xos         , Xos         , Xos         , Rrc         , Wog         , Wog         , Rrc         , Rrc         
Rrc         , Rrc         , Wog         , Wog         , Rrc         , Xos         , Xos         , Xos         , Dd^Edp      , Dd^Edpp     , Dd          , Wog         , Wog         , Hh          , Gs^Es       , Gg^Efm      , Gg^Efm      , Gs          , Hh          , Gg^Efm      , Wwg         , Wwrg        , Ss^Bw/r     , Ss^Bw|      , Wog         , Wog         , Gs^Fms      , Wwf         , Gg^Fds      , Wwf         , Hh          , Gs^Fds      , Gs^Fds      , Xos         , Xos         , Xos         , Rrc         , Wog         , Wog         , Rrc         , Rrc         
Rrc         , Rrc         , Wog         , Wog         , Rrc         , Xos         , Xos         , Xos         , Hd          , Hd^Edpp     , Dd          , Dd^Es       , Dd          , Wog         , Wog         , Wog         , Wwg         , Gs          , Wwg         , Wwg^Bw|     , Rp          , Wwf^Bw|r    , Wwg         , Ss          , Wwf         , Hh^Fds      , Hh^Fds      , Gs^Fms      , Gs^Fms      , Hh^Fp       , Wwf         , Wwg^Ewl     , Gs^Fds      , Xos         , Xos         , Xos         , Rrc         , Wog         , Wog         , Rrc         , Rrc         
Rrc         , Rrc         , Wog         , Wog         , Rrc         , Xos         , Xos         , Xos         , Hd          , Hd          , Hd          , Dd          , Dd^Edpp     , Dd          , Dd          , Dd          , Dd          , Wwf         , Rp          , Rp          , 2 Cud       , Rp          , Rp          , Wwrg        , Gs^Fms      , Gg^Fds      , Gg^Fds      , Hh^Fp       , Gg^Es       , Hh^Fp       , Gs^Efm      , Hh          , Hh^Fp       , Xos         , Xos         , Xos         , Rrc         , Wog         , Wog         , Rrc         , Rrc         
Rrc         , Rrc         , Wog         , Wog         , Rrc         , Xos         , Xos         , Xos         , Hd          , Cdr^Es      , Dd          , Dd          , Dd^Dr       , Dd          , Dd^Esd      , Dd          , Dd          , Wwg         , Rp          , Rp          , Cud         , Rp          , Rp          , Wwg         , Hh          , Gg          , Re          , Re          , Re          , Gs          , Gg^Fds      , Chr^Fms     , Gg^Fds      , Xos         , Xos         , Xos         , Rrc         , Wog         , Wog         , Rrc         , Rrc         
Rrc         , Rrc         , Wog         , Wog         , Rrc         , Xos         , Xos         , Xos         , Dd^Edpp     , Dd          , Dd^Do       , Dd^Edpp     , Dd          , Dd          , Dd          , Dd          , Ds          , Wwg^Bw/r    , Rp          , 4 Cud       , Rp          , 3 Cud       , Rp          , Wwf^Bw\r    , Gs          , Gs          , Gs^Fds      , Gg^Gvs      , Re          , Gg^Em       , Gg^Fds      , Hh^Fp       , Gg^Fms      , Xos         , Xos         , Xos         , Rrc         , Wog         , Wog         , Rrc         , Rrc         
Rrc         , Rrc         , Wog         , Wog         , Rrc         , Xos         , Xos         , Xos         , Dd          , Dd^Edpp     , Dd^Edpp     , Dd          , Dd^Esd      , Dd          , Wwf         , Dd          , Wwf         , Wwg         , Wwf^Bw/     , Rp          , Rp          , Rp          , Wwf^Bw\     , Wwg         , Wwf         , Ds          , Gg^Fet      , Gg^Fms      , Wwf         , Re          , Re          , Gs^Fds      , Gs^Fds      , Xos         , Xos         , Xos         , Rrc         , Wog         , Wog         , Rrc         , Rrc         
Rrc         , Rrc         , Wog         , Wog         , Rrc         , Xos         , Xos         , Xos         , Dd          , Dd^Edpp     , Dd          , Dd          , Dd          , Dd          , Wwf         , Wwg         , Uh          , Ur          , Uu^Uf       , Wwf         , Wwf         , Wwg         , Ai          , Ai          , Wwf         , Wwf         , Wwf         , Gs^Fms      , Gg^Fds      , Wwf         , Re          , Gd          , Gs^Fds      , Xos         , Xos         , Xos         , Rrc         , Wog         , Wog         , Rrc         , Rrc         
Rrc         , Rrc         , Wog         , Wog         , Rrc         , Xos         , Xos         , Xos         , Xos         , Dd          , Dd          , Dd          , Wwg         , Wwg         , Wwf         , Uh          , Ur          , Ur          , Uu          , Wwf         , Wwg         , Aa          , Aa          , Ai          , Wwg         , Wwf         , Wwf         , Wwf         , Wwg         , Wwf         , Gs          , Re          , Xos         , Xos         , Xos         , Xos         , Rrc         , Wog         , Wog         , Rrc         , Rrc         
Rrc         , Rrc         , Wog         , Wog         , Rrc         , Xos         , Rb          , Rb          , Rb          , Xos         , Wwf         , Wwf         , Wwg         , Wwg         , Uh          , Wwf         , Ur          , Uu          , Uu^Em       , Uu          , Wog         , Ha          , Aa          , Wwg         , Aa          , Aa          , Aa          , Wwf         , Aa          , Wwrg        , Wwf         , Xos         , Rb          , Rb          , Rb          , Xos         , Rrc         , Wog         , Wog         , Rrc         , Rrc         
Rrc         , Rrc         , Wog         , Wog         , Rrc         , Xos         , Xos         , Rb          , Rb          , Xos         , Xos         , Uu          , Uu^Es       , Uu^Uf       , Ur          , Ur          , Uu          , Xuc         , Uu          , Wwrg        , Wog         , Aa          , Ai          , Wwg         , Wwg         , Wwrg        , Ai          , Wwf         , Wwf         , Wwf         , Xos         , Xos         , Rb          , Rb          , Xos         , Xos         , Rrc         , Wog         , Wog         , Rrc         , Rrc         
Rrc         , Rrc         , Wog         , Wog         , Wog         , Rrc         , Rrc         , Xos         , Rb          , Rb          , Xos         , Ur          , Ur          , Ur          , Uu^Es       , Uu^Em       , Qxu         , Uu^Es       , Wwg         , Wwg         , Wog         , Wog         , Wwg         , Wwg         , Ai          , Wwg         , Wwg         , Wwg         , Wwg         , Aa          , Xos         , Rb          , Rb          , Xos         , Rrc         , Rrc         , Wog         , Wog         , Wog         , Rrc         , Rrc         
Rrc         , Rrc         , Rrc         , Wog         , Wog         , Wog         , Rrc         , Xos         , Rb          , Rb          , Xos         , Uh          , Uh          , Uh          , Uu^Em       , Qxu         , Qxu         , Wwg         , Uh^Es       , Wog         , Ai          , Aa          , Cha         , Aa          , Ms          , Ha^Fpa      , Wwf         , Wwg         , Wwg         , Aa^Es       , Xos         , Rb          , Rb          , Xos         , Rrc         , Wog         , Wog         , Wog         , Rrc         , Rrc         , Rrc         
Rrc         , Rrc         , Rrc         , Rrc         , Wog         , Wog         , Rrc         , Xos         , Xos         , Xos         , Xos         , Xos         , Xos         , Uu^Uf       , Uh          , Uu          , Uu^Uf       , Uu^Br\      , Uu^Em       , Wog         , Wwrg        , Aa^Fma      , Aa          , Aa          , Aa          , Ha          , Ms          , Ms          , Xos         , Xos         , Xos         , Xos         , Xos         , Xos         , Rrc         , Wog         , Wog         , Rrc         , Rrc         , Rrc         , Rrc         
Rrc         , Rrc         , Rrc         , Rrc         , Wog         , Wog         , Wog         , Rrc         , Rrc         , Xos         , Xos         , Xos         , Xos         , Xos         , Xos         , Uh^Uf       , Uu^Uf       , Uh          , Uu^Uf       , Uh          , Wwg         , Ai          , Ha^Fpa      , Ha^Fpa      , Aa          , Ha^Fma      , Xos         , Xos         , Xos         , Xos         , Xos         , Xos         , Rrc         , Rrc         , Wog         , Wog         , Wog         , Rrc         , Rrc         , Rrc         , Rrc         
Rrc         , Rrc         , Rrc         , Rrc         , Rrc         , Wog         , Wog         , Wog         , Wog^Bsb/    , Rrc         , Rrc         , Xos         , Xos         , Xos         , Xos         , Xos         , Xos         , Uh          , Wwg         , Wwg         , Wog         , Ai          , Ai          , Ha          , Xos         , Xos         , Xos         , Xos         , Xos         , Xos         , Rrc         , Rrc         , Wog^Bsb\    , Wog         , Wog         , Wog         , Rrc         , Rrc         , Rrc         , Rrc         , Rrc         
Rrc         , Rrc         , Rrc         , Rrc         , Rrc         , Rrc         , Rrc         , Wog^Bsb/    , Wog         , Wog         , Wog         , Rrc         , Rrc         , Xos         , Xos         , Xos         , Xos         , Xos         , Xos         , Wog         , Wog         , Wog         , Xos         , Xos         , Xos         , Xos         , Xos         , Xos         , Rrc         , Rrc         , Wog         , Wog         , Wog         , Wog^Bsb\    , Rrc         , Rrc         , Rrc         , Rrc         , Rrc         , Rrc         , Rrc         
Rrc         , Rrc         , Rrc         , Rrc         , Rrc         , Rrc         , Rrc         , Rrc         , Rrc         , Wog         , Wog         , Wog         , Wog^Bsb/    , Rrc         , Rrc         , Xos         , Xos         , Xos         , Xos         , Xos         , Xos         , Xos         , Xos         , Xos         , Xos         , Xos         , Rrc         , Rrc         , Wog^Bsb\    , Wog         , Wog         , Wog         , Rrc         , Rrc         , Rrc         , Rrc         , Rrc         , Rrc         , Rrc         , Rrc         , Rrc         
Rrc         , Rrc         , Rrc         , Rrc         , Rrc         , Rrc         , Rrc         , Rrc         , Rrc         , Rrc         , Rrc         , Wog^Bsb/    , Wog         , Wog         , Wog         , Rrc         , Rrc         , Xos         , Xos         , Xos         , Xos         , Xos         , Xos         , Xos         , Rrc         , Rrc         , Wog         , Wog         , Wog         , Wog^Bsb\    , Rrc         , Rrc         , Rrc         , Rrc         , Rrc         , Rrc         , Rrc         , Rrc         , Rrc         , Rrc         , Rrc         
Rrc         , Rrc         , Rrc         , Rrc         , Rrc         , Rrc         , Rrc         , Rrc         , Rrc         , Rrc         , Rrc         , Rrc         , Rrc         , Wog         , Wog         , Wog         , Wog^Bsb/    , Rrc         , Rrc         , Xos         , Xos         , Xos         , Rrc         , Rrc         , Wog^Bsb\    , Wog         , Wog         , Wog         , Rrc         , Rrc         , Rrc         , Rrc         , Rrc         , Rrc         , Rrc         , Rrc         , Rrc         , Rrc         , Rrc         , Rrc         , Rrc         
Rrc         , Rrc         , Rrc         , Rrc         , Rrc         , Rrc         , Rrc         , Rrc         , Rrc         , Rrc         , Rrc         , Rrc         , Rrc         , Rrc         , Rrc         , Wog^Bsb/    , Wog         , Wog         , Wog         , Rrc         , Rrc         , Rrc         , Wog         , Wog         , Wog         , Wog^Bsb\    , Rrc         , Rrc         , Rrc         , Rrc         , Rrc         , Rrc         , Rrc         , Rrc         , Rrc         , Rrc         , Rrc         , Rrc         , Rrc         , Rrc         , Rrc         
Rrc         , Rrc         , Rrc         , Rrc         , Rrc         , Rrc         , Rrc         , Rrc         , Rrc         , Rrc         , Rrc         , Rrc         , Rrc         , Rrc         , Rrc         , Rrc         , Rrc         , Wog         , Wog         , Wog         , Wog         , Wog         , Wog         , Wog         , Rrc         , Rrc         , Rrc         , Rrc         , Rrc         , Rrc         , Rrc         , Rrc         , Rrc         , Rrc         , Rrc         , Rrc         , Rrc         , Rrc         , Rrc         , Rrc         , Rrc         
