border_size=1
usage=map

Qxua^Xo     , Qxua^Xo     , Qxua^Xo     , Qxua^Xo     , Qxua^Xo     , Qxua^Xo     , Qxua^Xo     , Qxua^Xo     , Qxua^Xo     , Qxua^Xo     , Qxua^Xo     , Qxua^Xo     , Qxua^Xo     , Qxua^Xo     , Qxua^Xo     , Qxua^Xo     , Qxua^Xo     , Qxua^Xo     , Qxua^Xo     , Qxua^Xo     , Qxua^Xo     , Qxua^Xo     , Qxua^Xo     , Qxua^Xo     , Qxua^Xo     , Qxua^Xo     , Qxua^Xo     , Qxua^Xo     , Qxua^Xo     , Qxua^Xo     , Qxua^Xo     , Qxua^Xo     , Qxua^Xo     , Qxua^Xo     , Qxua^Xo     , Qxua^Xo     , Qxua^Xo     
Qxua^Xo     , Qxua^Xo     , Qxua^Xo     , Qxua^Xo     , Qxua^Xo     , Qxua^Xo     , Qxua^Xo     , Qxua^Xo     , Qxua^Xo     , Qxua^Xo     , Qxua^Xo     , Qxua^Xo     , Qxua^Xo     , Qxua^Xo     , Qxua^Xo     , Qxua^Xo     , Qxua^Xo     , Qxua^Xo     , Qxua^Xo     , Qxua^Xo     , Qxua^Xo     , Qxua^Xo     , Qxua^Xo     , Qxua^Xo     , Qxua^Xo     , Qxua^Xo     , Qxua^Xo     , Qxua^Xo     , Qxua^Xo     , Qxua^Xo     , Qxua^Xo     , Qxua^Xo     , Qxua^Xo     , Qxua^Xo     , Qxua^Xo     , Qxua^Xo     , Qxua^Xo     
Qxua^Xo     , Qxua^Xo     , Qxua^Xo     , Qxua^Xo     , 1 Kud       , Qxua^Xo     , 2 Kud       , Qxua^Xo     , 3 Kud       , Qxua^Xo     , Qxua^Xo     , Qxua^Xo     , Qxua^Xo     , Qxua^Xo     , Qxua^Xo     , Qxua^Xo     , Qxua^Xo     , Qxua^Xo     , Qxua^Xo     , Qxua^Xo     , Qxua^Xo     , Qxua^Xo     , Qxua^Xo     , Qxua^Xo     , Qxua^Xo     , Qxua^Xo     , Qxua^Xo     , Qxua^Xo     , 5 Kud       , Qxua^Xo     , 6 Kud       , Qxua^Xo     , 7 Kud       , Qxua^Xo     , Qxua^Xo     , Qxua^Xo     , Qxua^Xo     
Qxua^Xo     , Qxua^Xo     , Qxua^Xo     , Qxua^Xo     , Qxua^Xo     , Qxua^Xo     , Qxua^Xo     , Qxua^Xo     , Qxua^Xo     , Qxua^Xo     , Qxua^Xo     , Qxua^Xo     , Qxua^Xo     , Qxua^Xo     , Ww          , Qxua^Xo     , Ss          , Ss          , Ss          , Ss          , Ss          , Qxua^Xo     , Ww          , Qxua^Xo     , Qxua^Xo     , Qxua^Xo     , Qxua^Xo     , Qxua^Xo     , Qxua^Xo     , Qxua^Xo     , Qxua^Xo     , Qxua^Xo     , Qxua^Xo     , Qxua^Xo     , Qxua^Xo     , Qxua^Xo     , Qxua^Xo     
Qxua^Xo     , Qxua^Xo     , Qxua^Xo     , Qxua^Xo     , Qxua^Xo     , Qxua^Xo     , Qxua^Xo     , Qxua^Xo     , Qxua^Xo     , Qxua^Xo     , Qxua^Xo     , Qxua^Xo     , Gs^Fp       , Hh          , Ww          , Ww          , Ss          , Ss          , Ss          , Ss          , Ss          , Ww          , Ww          , Gs^Fp       , Hh          , Qxua^Xo     , Qxua^Xo     , Qxua^Xo     , Qxua^Xo     , Qxua^Xo     , Qxua^Xo     , Qxua^Xo     , Qxua^Xo     , Qxua^Xo     , Qxua^Xo     , Qxua^Xo     , Qxua^Xo     
Qxua^Xo     , Qxua^Xo     , Qxua^Xo     , Qxua^Xo     , Qxua^Xo     , Qxua^Xo     , Gs^Fp       , Hh          , Gg          , Gs^Fp       , Gg          , Hh          , Hh          , Gg          , Wwf         , Gs          , Gs          , Hh          , Mm          , Hh          , Gs          , Gs          , Wwf         , Gg          , Gs^Fp       , Gs^Fp       , Gg          , Hh          , Gg          , Gs^Fp       , Hh          , Qxua^Xo     , Qxua^Xo     , Qxua^Xo     , Qxua^Xo     , Qxua^Xo     , Qxua^Xo     
Qxua^Xo     , Qxua^Xo     , Qxua^Xo     , Qxua^Xo     , Qxua^Xo     , Qxua^Xo     , Gg          , Gg          , Ww          , Gg          , Ch          , Gg          , Gg          , Gg          , Ww          , Gs^Ft       , Gs          , Gs^Ft       , Rd          , Gs^Ft       , Gs          , Hh          , Ww          , Gg          , Gg          , Gg          , Ch          , Gg          , Ww          , Gg          , Gg          , Qxua^Xo     , Qxua^Xo     , Qxua^Xo     , Qxua^Xo     , Qxua^Xo     , Qxua^Xo     
Qxua^Xo     , Qxua^Xo     , Qxua^Xo     , Qxua^Xo     , Qxua^Xo     , Hh          , Gg          , Ww          , Dd^Do       , Wwf         , Wwf         , Wwf         , Ww          , Wwf         , Hh          , Ww          , Wwf         , Rd          , Hh          , Rd          , Wwf         , Ww          , Gs^Fp       , Wwf         , Ww          , Wwf         , Wwf         , Wwf         , Dd^Do       , Ww          , Gg          , Gs^Fp       , Qxua^Xo     , Qxua^Xo     , Qxua^Xo     , Qxua^Xo     , Qxua^Xo     
Qxua^Xo     , Qxua^Xo     , Qxua^Xo     , Qxua^Xo     , Hh          , Gg          , Gg          , Wwf         , Gg          , Gg          , Xu          , Xu          , Xu          , Gg          , Gg          , Gg          , Ww          , Hh          , Hh          , Hh          , Ww          , Gg          , Gg          , Gg          , Xu          , Xu          , Xu          , Gg          , Gg          , Wwf         , Gg          , Gg          , Gs^Fp       , Qxua^Xo     , Qxua^Xo     , Qxua^Xo     , Qxua^Xo     
Qxua^Xo     , Qxua^Xo     , Qxua^Xo     , Qxua^Xo     , Ce          , Gs^Fp       , Gg          , Ww          , Gg          , Gg          , Wwf         , Cud         , Xu          , Gs^Fp       , Hh          , Gs^Fp       , Ww          , Ww          , Ww          , Ww          , Ww          , Hh          , Gs^Fp       , Hh          , Xu          , Cud         , Wwf         , Gg          , Gg          , Ww          , Gg          , Hh          , Ce          , Qxua^Xo     , Qxua^Xo     , Qxua^Xo     , Qxua^Xo     
Qxua^Xo     , Qxua^Xo     , Qxua^Xo     , Ce          , 4 Ce        , Ce          , Wwf         , Wwf         , Wwf         , Wwf         , Gg          , Cud         , Xu          , Uu          , Uu^Uf       , Ww          , Wo          , Wo          , Wo          , Wo          , Wo          , Ww          , Uu^Uf       , Uu          , Xu          , Cud         , Gg          , Wwf         , Wwf         , Wwf         , Wwf         , Ce          , 8 Ce        , Ce          , Qxua^Xo     , Qxua^Xo     , Qxua^Xo     
Qxua^Xo     , Qxua^Xo     , Qxua^Xo     , Ce          , Ce          , Ce          , Gg          , Wwf         , Gg          , Wwf         , Wwf         , Cud         , Xu          , Uu          , Gs^Fp       , Ww          , Ww          , Wo          , Ww          , Wo          , Ww          , Ww          , Hh          , Uu          , Xu          , Cud         , Wwf         , Wwf         , Gg          , Wwf         , Gg          , Ce          , Ce          , Ce          , Qxua^Xo     , Qxua^Xo     , Qxua^Xo     
Qxua^Xo     , Qxua^Xo     , Qxua^Xo     , Qxua^Xo     , Gs^Fp       , Hh          , Gg          , Ww          , Gg          , Gg          , Xu          , Cud         , Xu          , Hh          , Gg          , Hh          , Ww          , Ww          , Hh          , Ww          , Ww          , Gs^Fp       , Gg          , Gs^Fp       , Xu          , Cud         , Xu          , Gg          , Gg          , Ww          , Gg          , Gs^Fp       , Hh          , Qxua^Xo     , Qxua^Xo     , Qxua^Xo     , Qxua^Xo     
Qxua^Xo     , Qxua^Xo     , Qxua^Xo     , Qxua^Xo     , Qxua^Xo     , Gg          , Gg          , Wwf         , Dd^Do       , Gg          , Wwf         , Xu          , Ww          , Gg          , Gs^Fp       , Gg          , Wwf         , Hh          , Hh          , Hh          , Wwf         , Gg          , Hh          , Gg          , Ww          , Xu          , Wwf         , Gg          , Dd^Do       , Wwf         , Gg          , Gg          , Qxua^Xo     , Qxua^Xo     , Qxua^Xo     , Qxua^Xo     , Qxua^Xo     
Qxua^Xo     , Qxua^Xo     , Qxua^Xo     , Qxua^Xo     , Qxua^Xo     , Gs^Fp       , Gg          , Ww          , Ww          , Wwf         , Ch          , Wwf         , Gg          , Wwf         , Ww          , Ww          , Gs          , Rd          , Rd          , Rd          , Gs          , Ww          , Ww          , Wwf         , Gg          , Wwf         , Ch          , Wwf         , Ww          , Ww          , Gg          , Hh          , Qxua^Xo     , Qxua^Xo     , Qxua^Xo     , Qxua^Xo     , Qxua^Xo     
Qxua^Xo     , Qxua^Xo     , Qxua^Xo     , Qxua^Xo     , Qxua^Xo     , Qxua^Xo     , Hh          , Gg          , Gg          , Gg          , Gg          , Gg          , Gs^Fp       , Gg          , Wwf         , Hh          , Gs          , Gs^Ft       , Mm          , Gs^Ft       , Gs          , Gs^Ft       , Wwf         , Gg          , Hh          , Gg          , Gg          , Gg          , Gg          , Gg          , Gs^Fp       , Qxua^Xo     , Qxua^Xo     , Qxua^Xo     , Qxua^Xo     , Qxua^Xo     , Qxua^Xo     
Qxua^Xo     , Qxua^Xo     , Qxua^Xo     , Qxua^Xo     , Qxua^Xo     , Qxua^Xo     , Qxua^Xo     , Gs^Fp       , Qxua^Xo     , Hh          , Qxua^Xo     , Gs^Fp       , Hh          , Gg          , Ww          , Gs          , Ss          , Hh          , Ss          , Hh          , Ss          , Gs          , Ww          , Gg          , Gs^Fp       , Hh          , Qxua^Xo     , Gs^Fp       , Qxua^Xo     , Hh          , Qxua^Xo     , Qxua^Xo     , Qxua^Xo     , Qxua^Xo     , Qxua^Xo     , Qxua^Xo     , Qxua^Xo     
Qxua^Xo     , Qxua^Xo     , Qxua^Xo     , Qxua^Xo     , Qxua^Xo     , Qxua^Xo     , Qxua^Xo     , Qxua^Xo     , Qxua^Xo     , Qxua^Xo     , Qxua^Xo     , Qxua^Xo     , Qxua^Xo     , Gs^Fp       , Qxua^Xo     , Ww          , Ss          , Ss          , Ss          , Ss          , Ss          , Ww          , Qxua^Xo     , Hh          , Qxua^Xo     , Qxua^Xo     , Qxua^Xo     , Qxua^Xo     , Qxua^Xo     , Qxua^Xo     , Qxua^Xo     , Qxua^Xo     , Qxua^Xo     , Qxua^Xo     , Qxua^Xo     , Qxua^Xo     , Qxua^Xo     
Qxua^Xo     , Qxua^Xo     , Qxua^Xo     , Qxua^Xo     , Qxua^Xo     , Qxua^Xo     , Qxua^Xo     , Qxua^Xo     , Qxua^Xo     , Qxua^Xo     , Qxua^Xo     , Qxua^Xo     , Qxua^Xo     , Qxua^Xo     , Qxua^Xo     , Qxua^Xo     , Qxua^Xo     , Ss          , Qxua^Xo     , Ss          , Qxua^Xo     , Qxua^Xo     , Qxua^Xo     , Qxua^Xo     , Qxua^Xo     , Qxua^Xo     , Qxua^Xo     , Qxua^Xo     , Qxua^Xo     , Qxua^Xo     , Qxua^Xo     , Qxua^Xo     , Qxua^Xo     , Qxua^Xo     , Qxua^Xo     , Qxua^Xo     , Qxua^Xo     
Qxua^Xo     , Qxua^Xo     , Qxua^Xo     , Qxua^Xo     , Qxua^Xo     , Qxua^Xo     , Qxua^Xo     , Qxua^Xo     , Qxua^Xo     , Qxua^Xo     , Qxua^Xo     , Qxua^Xo     , Qxua^Xo     , Qxua^Xo     , Qxua^Xo     , Qxua^Xo     , Qxua^Xo     , Qxua^Xo     , Qxua^Xo     , Qxua^Xo     , Qxua^Xo     , Qxua^Xo     , Qxua^Xo     , Qxua^Xo     , Qxua^Xo     , Qxua^Xo     , Qxua^Xo     , Qxua^Xo     , Qxua^Xo     , Qxua^Xo     , Qxua^Xo     , Qxua^Xo     , Qxua^Xo     , Qxua^Xo     , Qxua^Xo     , Qxua^Xo     , Qxua^Xo     
Qxua^Xo     , Qxua^Xo     , Qxua^Xo     , Qxua^Xo     , Qxua^Xo     , Qxua^Xo     , Qxua^Xo     , Qxua^Xo     , Qxua^Xo     , Qxua^Xo     , Qxua^Xo     , Qxua^Xo     , Qxua^Xo     , Qxua^Xo     , Qxua^Xo     , Qxua^Xo     , Qxua^Xo     , Qxua^Xo     , Qxua^Xo     , Qxua^Xo     , Qxua^Xo     , Qxua^Xo     , Qxua^Xo     , Qxua^Xo     , Qxua^Xo     , Qxua^Xo     , Qxua^Xo     , Qxua^Xo     , Qxua^Xo     , Qxua^Xo     , Qxua^Xo     , Qxua^Xo     , Qxua^Xo     , Qxua^Xo     , Qxua^Xo     , Qxua^Xo     , Qxua^Xo     
Qxua^Xo     , Qxua^Xo     , Qxua^Xo     , Qxua^Xo     , Qxua^Xo     , Qxua^Xo     , Qxua^Xo     , Qxua^Xo     , Qxua^Xo     , Qxua^Xo     , Qxua^Xo     , Qxua^Xo     , Qxua^Xo     , Qxua^Xo     , Qxua^Xo     , Qxua^Xo     , Qxua^Xo     , Qxua^Xo     , Qxua^Xo     , Qxua^Xo     , Qxua^Xo     , Qxua^Xo     , Qxua^Xo     , Qxua^Xo     , Qxua^Xo     , Qxua^Xo     , Qxua^Xo     , Qxua^Xo     , Qxua^Xo     , Qxua^Xo     , Qxua^Xo     , Qxua^Xo     , Qxua^Xo     , Qxua^Xo     , Qxua^Xo     , Qxua^Xo     , Qxua^Xo     
